912
{'डस्', 'ढाक्', 'खरो', 'खुद्रा', 'कुम्ले', 'ओली', 'टिप्', 'भुक्', 'घोरि', 'खप्', 'जाग्राम', 'टाल्', 'अल्लारि', 'बात', 'बुवा', 'खोल्', 'सुरि', 'खाँभो', 'भन्टा', 'हाल्', 'भरपाई', 'चौरस', 'जेल्', 'झिँजि', 'सिक्', 'हेर्', 'हौस', 'फिट्', 'पुकार्', 'घुर्', 'बोल्', 'तल', 'किट्', 'हे', 'जुठि', 'धम्कि', 'वाह', 'छाँट्', 'धाक', 'भत्क', 'माहुरी', 'इतरि', 'टठमराउ', 'जुट्', 'घर', 'थर्क', 'चुलि', 'अधकल्चि', 'कप्टेरि', 'फोड्', 'क्याम्प', 'जोत्', 'कथ्', 'सेट', 'मैलि', 'एकोहरो', 'कुप्रो', 'गर्', 'गन्हाउ', 'अनुसार', 'उछिन्', 'नाप्', 'बहुला', 'झुत्ति', 'उनी', 'असिना', 'पट्', 'झुल्', 'लिखत', 'छचल्कि', 'छर्', 'छड्के', 'खराउ', 'कन्याउ', 'साँध्', 'सक्', 'डक्', 'छम्क', 'हिल्याउ', 'दबदब', 'पाल्', 'हान्', 'ललकार्', 'झर्', 'उधि', 'वानर', 'ततर्को', 'बूढी', 'कोत्रि', 'छास्', 'गम्य', 'उकेर्', 'निछाउ', 'उखेल्', 'रति', 'तन्क', 'पटार्', 'बुबा', 'मिल्', 'भल्', 'सुधार', 'बुहारी', 'घुसमुन्टि', 'कुर्', 'धक्', 'भ्याउ', 'कोख', 'झुम्रि', 'बेर्', 'पुहुनी', 'गन्', 'ओझाउ', 'हिर्काउ', 'चाल्', 'फाँको', 'कुकाउ', 'छेद्', 'खरखर', 'चेप्', 'होचि', 'घोल्', 'बर्', 'तक्', 'मान्', 'हर्', 'पोल्टि', 'फुक्', 'पछाउ', 'फेरि', 'ठेस्', 'चौटि', 'बेकाम', 'भलो', 'भट्ट्याउ', 'टट्कारो', 'डेब्रि', 'बग्', 'कुँढ्', 'देवर', 'कुट्', 'अल्प', 'पहिरो', 'भज्', 'तर्', 'गँगरि', 'चिम्टि', 'नत्थ्याउ', 'ठाँट', 'टल्', 'ढिक', 'तनक्क', 'मोस्', 'खुट्टि', 'चिल्लाउ', 'खुँड्', 'अठोट्', 'ओछ्याउ', 'मथ्', 'अर्प', 'मल्', 'टाँग्', 'हेलमेल', 'झेल्', 'लरी', 'खलबल', 'घबडाउ', 'खस्रि', 'हत्तपत्त', 'भाउँटो', 'बिहान', 'धोत्रि', 'कुहु', 'धोक्', 'लड्', 'टकराउ', 'ठहर्', 'खिच्', 'दिक्दार', 'मन्स', 'खौलि', 'पोत्', 'लिप्', 'चुत्थि', 'सुद्धि', 'चोइटि', 'हकि', 'दचक', 'घिच्चि', 'काकातुवा', 'तर', 'लाग्', 'मुसार्', 'गल्', 'झोलि', 'ठटाउ', 'घुँगुरि', 'झुक्कि', 'जाक्', 'भुवन', 'झ्याँक्', 'राँकि', 'चुइँक्याउ', 'खिल्', 'अड्', 'कात्', 'हार', 'फिर्', 'मन्त्र', 'कोक्रो', 'फागुन', 'बिभिन्डि', 'च्याप्', 'खेद्', 'चिल्', 'सन्चो', 'हँसिया', 'चुच्चि', 'बित्', 'घडी', 'सङ्ग्रालो', 'लत्र', 'फुट्', 'खोसेल्टि', 'कह', 'गान्टो', 'गुँडुलि', 'भुकभुक्याउ', 'भित्तो', 'रच्', 'छाद्', 'घुस्सि', 'भेद्', 'पिस्', 'खटन', 'एउटा', 'तुइँक्याउ', 'रुँग्', 'धु', 'थाप्', 'जाग्', 'छिर्', 'तुहु', 'माड्', 'टुङ्गि', 'चर्च', 'चहक', 'जल्', 'चोभ्', 'सुल्याउ', 'बदल्', 'पट्याउ', 'टिक्', 'घस्', 'टाँस्', 'भाँच्', 'लोसि', 'कस्', 'कहलाउ', 'राजकाज', 'कल्प', 'गफल्क्याउ', 'चाट्', 'खोस्', 'पुल्', 'ढाल्', 'बस्', 'पतल्याउ', 'हट्', 'टाँगा', 'थुर्', 'ठप्प', 'सम्झ', 'रिँगटा', 'लुँडि', 'वैतरणी', 'घुच्च्याउ', 'हिस्सि', 'झोक्रि', 'पोल्', 'सकार्', 'बहिनी', 'चुन्', 'वर', 'टामटुम', 'हिक्', 'निहुर', 'हु', 'लफलफ', 'टक्र', 'रसाउ', 'बुकुनु', 'चिलाउ', 'सुन्', 'टुप्पि', 'खिइ', 'बाबा', 'पत्ताउ', 'जुर्', 'बैङ्क', 'सर्क', 'कज्याउ', 'मनाही', 'कोत्रो', 'गैँडा', 'सहजाउ', 'लहुरो', 'बाबु', 'हाँक्', 'पहेँलि', 'पिल्सि', 'मुस्कुराउ', 'तग्', 'असोज', 'लुलि', 'गुठुरि', 'खेल्', 'फस्', 'अररि', 'बहार', 'मुनाल', 'भुँडी', 'बोरा', 'कुँडुलि', 'भक्रन्त', 'चुभुर्कि', 'धाउ', 'नाता', 'टक', 'घमन्ड', 'लोलाउ', 'झिल्को', 'ठग्', 'ढाड', 'कागजी', 'निल्', 'पस्', 'दौड', 'खट्', 'साउती', 'डिट्ठा', 'झट्ट', 'बिक्', 'अमिलि', 'दि', 'रोल्', 'सराप्', 'डौँडारि', 'दुख्', 'कर्कि', 'दुहु', 'थुप्रि', 'राख्', 'धतुराउ', 'कुँडि', 'छटछट', 'खेल', 'बिउ', 'हिँड्', 'पगार्', 'खुर्सानी', 'कर्क', 'झड्कार्', 'बोर्', 'माग्', 'तात्', 'ठोस्', 'डकुल्ल्याउ', 'फुल्', 'साध्', 'फाट्', 'कोर्', 'लुटि', 'भल', 'दह्रि', 'अरकच्च', 'उड्', 'पोस्', 'बजार्', 'उठ्', 'गठरि', 'डाँस्', 'रू', 'टुइँकि', 'केरा', 'दँद्याउ', 'मोहडा', 'गह्रुङ्गो', 'झप्पू', 'साट्', 'रिटाउ', 'ङ्याच्', 'मुढि', 'पल्ट', 'आहारिस', 'झुक्', 'पिट्', 'अहिले', 'ओसार्', 'खप्पर', 'लट्ठी', 'अह्राउ', 'बुझ्', 'उजाउ', 'जकड्', 'लेदो', 'घ्याँक्', 'मात्ति', 'अपर्झट', 'डोल्', 'छिट्', 'लुसि', 'कप्', 'रङ्ग', 'बरखी', 'जोख्', 'मर्क', 'अपाम्मे', 'घबराउ', 'तार्', 'परपरि', 'टेढि', 'ढङ्ग', 'कमाउ', 'तुल्याउ', 'हाँस्', 'थिच्', 'आय', 'झोर्', 'तुर्', 'फाँद्', 'बिलाउ', 'भुत्लि', 'थुन्', 'पच्', 'खद्दर', 'झम्ट', 'ठेल्', 'ताक्', 'पट्कि', 'फोर्', 'भण्डारी', 'खोलो', 'कोक्याउ', 'सग्लाउ', 'पोख्', 'ओसाउ', 'लाहा', 'माझ्', 'औताउ', 'थुक्', 'खोक्रि', 'तिर्', 'रिङ्', 'थतर्कि', 'लस्क', 'लामो', 'झन्कि', 'मिस्', 'सुत्', 'एकलो', 'घट्', 'गाउ', 'ठिँगुरि', 'मस्क', 'अनरसा', 'लछार्', 'राँध्', 'गुणा', 'कहिले', 'बास्ना', 'तोड्', 'गिर्', 'खहरि', 'पखाल्', 'जोर्', 'चम्क', 'थाना', 'मनसाय', 'चुक्', 'धुरि', 'थुँग्', 'गर्ज', 'चल्', 'खकार्', 'नकचरि', 'सँभल्', 'खोस्टो', 'हस्स', 'खरदार', 'ठीक', 'ऐँठ', 'खोक्', 'जड्', 'खलमल', 'दमाहा', 'चिरबिर', 'धुस्नि', 'खोप्', 'चुक्ति', 'जिलो', 'पहिचान', 'भुस', 'खाप्', 'झार्', 'झुसि', 'बताउ', 'कानो', 'सिरेटो', 'डह', 'रेल्', 'बच्', 'हल्ला', 'ठडि', 'फूर्ति', 'भास्', 'टहल', 'छल्', 'झान्', 'जम्', 'अथुलाउ', 'जित्', 'बनेल', 'धान्', 'सर्सराउ', 'लतक्क', 'छिन्', 'थेग्', 'सिट्', 'बन्', 'पुस्टाउ', 'झट्कार्', 'ढाप्', 'फारो', 'रेट्', 'फन्दा', 'बुगुल्टि', 'हग्', 'हाँक', 'पछुतो', 'बर्खि', 'बुजि', 'बक्स', 'डाक्', 'कुच्चि', 'लेखा', 'फाटफुट', 'रम्', 'कुरो', 'घुम्', 'पहिलो', 'खपिस', 'डेलि', 'ओढ्', 'बेढाउ', 'सह', 'बाझ्', 'अस्ताउ', 'मर्', 'लटपट', 'थुत्', 'बुकाउ', 'चुम्', 'बेध्', 'फेट्', 'ठोक्', 'सुइँक', 'डग्', 'रँग्', 'चिसि', 'उभाउ', 'किच्', 'खोतर्', 'बाम', 'सन', 'धर्', 'भन्', 'अड्क', 'प्यू', 'चुस्', 'ढल्', 'चेवा', 'बिँड', 'उजाड', 'थानेदार', 'कोच्', 'तोक्', 'टप्', 'दल्', 'डोरि', 'बज्र', 'मोहनी', 'छिल्', 'नेप्टि', 'गहिरो', 'फल्', 'खत', 'रेत्', 'मनि', 'फेरा', 'खेर्', 'हात', 'जिलाउ', 'घसेट्', 'बाहाँ', 'खस्', 'दुलही', 'पहिले', 'गँवार', 'लोट्', 'सप्काउ', 'निम्ठि', 'घोट्', 'चौतारो', 'बाल्', 'छाउ', 'गढ', 'जोड्', 'घट्काउ', 'खोद्', 'चेत्', 'डकार', 'बिन्', 'तान्', 'उन्', 'उझाउ', 'डोली', 'निदाउ', 'हडबड', 'जिउनार', 'झुरि', 'झुत्रि', 'खुकुलो', 'सँग', 'छेड्', 'समाउ', 'लाद्', 'बाँध्', 'चपाउ', 'छाम्', 'कुद्', 'बर्क', 'खरि', 'खोले', 'भोग्', 'निसासि', 'लम्क', 'छुट्टि', 'दाप्', 'वरपर', 'पठाउ', 'छेस्कि', 'भेट्', 'छुस्कर', 'निखार्', 'धाप', 'खलो', 'मुड', 'चास्', 'बह', 'चुहु', 'पड्कि', 'बिगबिगाउ', 'ओथाउ', 'बीज', 'अँध्यार', 'रावण', 'कमर', 'सँभार्', 'बैठान', 'काँप्', 'सड्', 'चाख्', 'करुवा', 'हुल्', 'वैर', 'गाड्', 'घोच्', 'रगेल्', 'सिठो', 'आँक्', 'छाप्', 'भेट्टाउ', 'खोल्सि', 'चेप्टि', 'झाँट्', 'सिउ', 'पछ्याउ', 'भर्', 'हुँडल्', 'अराउ', 'झपक्क', 'पर्स', 'भुङ्ग्रि', 'बारम्बार', 'फागु', 'खस्रो', 'भुल्', 'ठ्याक्क', 'ललाउ', 'राह', 'डाँठ', 'ढोग्', 'पिउ', 'पर्', 'हर्क', 'आत्ति', 'खरिद्', 'उल्टो', 'अँध्यारो', 'लिप्टि', 'लत्रक्क', 'चिर्', 'मच्क', 'फुस्रि', 'लोप्रि', 'उँग्', 'घाँटी', 'अर्मल्', 'थप्', 'अघाउ', 'बूढो', 'ओकल्', 'जर्क', 'कुट्कि', 'बहुलाउ', 'सडक', 'सप्र', 'चोर्', 'वार', 'कक्र', 'सामान', 'धर', 'तामा', 'खलक', 'सुक्', 'महक', 'खडा', 'हियाउ', 'मुल्कि', 'दर्', 'टाँक्', 'खुम्रि', 'गुम्', 'पाँद्', 'चाख', 'सातु', 'सुम्लि', 'पिँध्', 'करेप्', 'हल्क', 'मल्लिँडो', 'जप्', 'तप्', 'टोक्', 'त्यस', 'बुच्चि', 'ठास्', 'पिर्', 'एकसरि', 'छुट', 'स्मरण', 'सित', 'काट्', 'ढुङ्गो', 'बिराउ', 'आफल्', 'लट्टि', 'जुवारी', 'जन्म', 'घुम्रि', 'कोल्टो', 'टुकटुक', 'माइती', 'तर्क', 'अक्र', 'बिडा', 'छेक्', 'काउछो', 'दपेट्', 'रमझम', 'किन्', 'पनिउँ', 'खिचखिच', 'टुक्रि', 'भुट्', 'ढोल', 'रोज्', 'फोगटो', 'निस्ति', 'बुङ्गि', 'सात', 'खाल', 'लछार', 'जनाउ', 'दाँज्', 'फेर्', 'दाग्', 'अकासि', 'छेको', 'मिठि', 'पेस्', 'सह्राउ', 'गिजि', 'डोब्', 'खोचि', 'ठिङ्गि', 'गुड्', 'कोखो', 'तीन', 'फुर्', 'चिन्', 'बिछाउ', 'ङ्याक्', 'पाद्', 'दन्क', 'खुट्', 'गोड्', 'ङिच्च', 'टट्टाउ', 'खुल्', 'गुन्', 'बिरुवा', 'बिहा', 'धुन्', 'केर्', 'नकच्चरि', 'लम्बि', 'लिप्स', 'लुक्', 'मुन्टि', 'गोरखा', 'चकार्', 'छु', 'धरती', 'कराउ', 'छान्', 'लोला', 'भिर्', 'पड्', 'होम्', 'एकले', 'खर', 'भोक', 'टाक्सि', 'लरलर', 'फ्याँक्', 'लतपत', 'टेर्', 'टेक्', 'छेर्', 'थाक्', 'बिथोल्', 'अग्लि', 'हद', 'नुहाउ', 'खाँच', 'चर्', 'पन्साउ', 'उब्र', 'स्याहार', 'मास्', 'झोक', 'सुम्ठ्याउ', 'कान', 'पुल्कि', 'कातर', 'छाँद्', 'बल्', 'मोड्', 'बौर', 'बज्', 'भाँड्', 'बढ्', 'लादी', 'ठुङ्', 'चोप्', 'दाउ', 'छुट्टा', 'खचाखच', 'खर्च', 'भुटभुटि', 'डाँक्', 'उम्', 'फक्र', 'देख्', 'खोसल्टि', 'राम्', 'लोभि', 'लेप्', 'वैलाउ', 'उब्ज', 'मड्क', 'कचल्टि', 'घुस्', 'खाल्टो', 'छत्रि', 'इँट', 'हल्ल', 'नाघ्', 'लपलप', 'लग्', 'कुँडुलो', 'पुत्ताउ', 'फच्चे', 'दुनु', 'फक्कड', 'नाच्', 'नार्', 'भाक्', 'ताछ्', 'चार', 'लुट्'}
अँध्यारो|ADJM	अँध्यारो|NN	
अल्प|ADJ	अल्प|ADJM	
असोज|NN	असोज|PN	
उजाड|ADJ	उजाड|NN	
ओथाउ|VC	ओथाउ|VF	
कल्प|VF	कल्प|NN	
कातर|ADJ	कातर|ADJM	
खपिस|ADJ	खपिस|ADJM	
गुठुरि|NN	गुठुरि|VF	
ङिच्च|NN	ङिच्च|ADV	
चर्च|NN	चर्च|NN,VF	
चहक|NN	चहक|VF	
चिम्टि|NN	चिम्टि|VF	
चिसि|NN	चिसि|VF	
छुट्टा|ADJ	छुट्टा|ADJM	
जन्म|NN	जन्म|NN,VF	
झट्ट|NN	झट्ट|ADV	
झुसि|NN	झुसि|VF	
टुप्पि|NN	टुप्पि|VF	
ठग्|NN	ठग्|VF	
ठाँट|NN	ठाँट|VF	
ठीक|ADJ	ठीक|ADJM	
डेब्रि|ADJM	डेब्रि|VF	
ढिक|NN	ढिक|NN,ADJM	
ढोल|NN	ढोल|VF	
तर|SCON	तर|NN,ADJM,SCON	
तर्क|NN	तर्क|VF	
थाक्|PN	थाक्|VF	
दाउ|NN	दाउ|VF	
दिक्दार|NN	दिक्दार|ADJM	
दौड|NN	दौड|VF	
नकचरि|ADJM	नकचरि|VF	
नाच्|NN	नाच्|VF	
नेप्टि|ADJM	नेप्टि|VF	
पगार्|V	पगार्|VF	
पहिलो|ADJM	पहिलो|NUMC	
पहिले|AVP	पहिले|ADV	
पाद्|NN	पाद्|VF	
पुकार्|NN	पुकार्|VF	
पुल्कि|NN	पुल्कि|VF	
फक्कड|ADJ	फक्कड|NN	
फेरि|AVP	फेरि|ADV	
बज्र|NN	बज्र|VF	
बह|NN	बह|VF	
बहुला|ADJM	बहुला|NN	
बाम|ADJ	बाम|NN,ADJM	
बारम्बार|ADVM	बारम्बार|ADV	
बुकुनु|NN	बुकुनु|ADJM	
बुच्चि|ADJM	बुच्चि|VF	
बूढो|ADJM	बूढो|NN	
बेढाउ|NN	बेढाउ|VF	
बेर्|NN	बेर्|VF	
भुक्|NN	भुक्|VF	
भुल्|NN	भुल्|VF	
भुल्|NN	भुल्|VF	
मन्त्र|NN	मन्त्र|VF,NN	
महक|NN	महक|VF	
मुड|NN	मुड|VF	
रति|PN	रति|VF	
लामो|NN	लामो|ADJM	
लिखत|NN	लिखत|ADJM	
लुँडि|VF	लुँडि|NN	
लेखा|NN	लेखा|VF	
लोसि|ADJM	लोसि|VF	
वाह|INTJ	वाह|ADJM	
वैर|NN	वैर|VF	
सप्काउ|NN	सप्काउ|VF	
समाउ|NN	समाउ|VF	
सराप्|NN	सराप्|VF	
सह|NN	सह|VF	
सुद्धि|NN	सुद्धि|VF	
हर्क|NN	हर्क|VF	
934
